21101000000000000010
01001001110011110000
00000001000000000000
01110111000100000000
01010011010111111000
01011011010100000000
01010011110111100000
11000000000010100000
00000000000010100001
00000001111010000000
11111111001010000000
00001000000010001100
00011111000110001000
00110011000100000000
00011110000100000000
00000000000100000000
00001110011111111110
11001000010000000000
01101000010011111111
00001000010000000000
