00000001000000000000
11111011011111101111
00001000001010101000
11100011101000101010
00111000111010101011
01110010001010100000
00000111101011101010
01111101001000001010
01010001100011011110
01000100001001010011
01011111101001010110
11000000111101110100
00011110100100000001
01010000101110111101
01010101101010100101
01110101000010110101
01000101011110010101
01111101010000010101
00000001010001110101
11111111000000000000
